#################################################
#        #               # ................     #
#    #####               # .                    #
#        #               # .   ##################
#        #                 .                    #
#              ...............................  #
#              .         #  .                .  #
#        #     .         #  .                .  #
#        ##### . #########  . #############  .  #
#        #.............. #  .                .  #
#        #.    .       . #  ..................  #
#        #.............. #                      #
#################################################
